...................................................................................................##############.........#..................................................................#.........
...........GGG.....................................................................................#............#.........#..................................................................#.........
...GGG.......................................GGGA...................................GGG............#GGG......P..#........##..........GG.........................G......................................
...---......................................#####..................................................#---#-...##..#...................----.........................G.....................................
......................GG...........................................................................#...#....#...#..............A...............G.............GGGGGG.........................##.........
GGG....~...........--------.....:......GGG........GGG.............................:................#GGG#....#...#........##...###.............G.G................G......................D.##-#.......GG
---....................................---........---.........GGG...GGG............................#---#-...#GGG#.........#..................G.G.G..............G.....................D.##---#.......--
.............................................................G...G.G...G.................-.............#....#.............#.................G.GDG.G.....----...............#..........##-----#....X....
.....1.....G..G....#..A...#.................................G.....G.....G..P.#...D.....#---#...........#....#..A...#......#................#########.......................#........##-------#.........
##############################################################...###...####################################################................#########.........##########....############################