######################################################
#....................................................#
#..........................................GGGGG.....#
#.........................................G.-.-.G....#
#.......G...G.GGG.G....GG...GG...G.G..GGG.G.....G....#
#.......G...G.G...G...G....G..G.G.G.G.G...G-...-G....#
#.......G.G.G.GG..G...G....G..G.G.G.G.GG..G.---.G....#
#...X...G.G.G.G...G...G....G..G.G...G.G....GGGGG...Y.#
#...1....G.G..GGG.GGG..GG...GG..G...G.GGG............#
######################################################