.................
....!............
.................
.................
.................
.................
.................
..X...........Y..
..1..............
#################