..................................................................................
...X..............................................................................
........................................:.........................................
..-#-.................................GGGG...........C......C...GG................
......................................GGGG.........#---....---#.GG................
................:.........C.......C...1..C....C....#..........#.C......C..........
.GG......................--......--..---#---..---.-#..........#----...---#.GG.....
.GG........P............................#..........#..........#..........#.GG..Y..
.......D...#....D.....#.................#..........#..........#..........#........
#######################................###........###........###........##########