#############################
#--#.....GGG.GGG.GGG.....#--#
#--#.....GGG.GGG.GGG.....#--#
#--#..X..GGG.GGG.GGG..X..#--#
#--#..1......D...........#--#
#############################
.............................
.............................
.........................#--#
#############################