####################################################################################################################
#####....####................###GG................#......#...........#--#.....GGG.GGG.GGG.....#--#........~........#
#.X...........................##GG..........A.....#.D....#...........#--#.....GGG.GGG.GGG.....#--#.................#
#.1.......D.................D..###...#----------..#--#...#....GG.#...#--#..X..GGG.GGG.GGG..X..#--#.................#
#####....####...---...---...#...##...#............#..#...#.......#...#--#........D............#--#.C..C..C..#......#
#####..:.####.......~.......##...##--#..~.GG....A.#.D#...#---#####...#############################---------##......#
#####-...####...............###......#...---------#--#.......#............................................###GG....#
#####G.G.####-..............####.....#...............#.......#G...G...G...G...G...G...G...G..............####GG.X..#
#####.G.G####.......G.......#####....#....A.....A....#.......#..G.A.G.A.G.A.G.A.G.A.G.A.G.A.G.#--#......#####......#
#############.......#.......#######..#################...###########################################################