######.................#.~...##....:....................................................#--#.........
.X...#........C........#..X.............B...............................................#--#..G.G.G.G
.1...#........#........#..B.........#########............C..............C...............#--#...G.G.G.
###-.#...C....#..----..########.B...#..GGG..#...--......--......--......--..............#--#..G.G.G.G
........----..#....~...#.GGGG.#######..GGG..#...........................................#--#...G.G.G.
.GG...........#........#.GGGG.#...........................~.....................DD......#--#....C....
.GG...........#.......................-----........................G.G.G:G.G...####.....#--#..-------
.D......----.....D..D..D..D..D....................................G.G.G.G.G.G.#----#....#--#.........
----.............#############...-----.....-----.....---.......A......D.....D#------#...#--#.........
...........................................................###########################..#--#.........