.....#--#................................................~.........................
.....#--#..G.G.G.G...........................................................X.....
.....#--#...G.G.G................................................GG......B..#1.....
.....#--#..G.G.G.G..............................C........B......----...#########...
.....#--#...G.G.G......................BB......---......-##-.......................
.....#--#....C........................###..........................................
.....#--#..--------.........#..................Y...................................
#....#--#..........................................................................
-#...#--#....................................----..................................
###..#--#..........................................................................